000000000000000000000000000000000000000000000000000000000000000000000000002
000000222200000000000000000000000000000000000000000000000000000000000000001
200000000000000000000000000222222222222200000000022222222222000000000000001
100000000000000002222000000000000000000000000000000000000000000000000000001
100000022222000000000000000000000000000000220000000000000000000000000000001
100000000000000000000000000000000222000000000000000000000000000000000000001
100000000000000000000222222200000000000000000000000000000000000000000000001
122222222222222222222111111122222222222222222222222222222222222222222222221

